###############
#      @      #
#    b   b    #
###         ###
###    b    ###
###    b    ###
###    b    ###
###    b    ###
###    b    ###
###    b    ###
#      o      #
#           b #
#######  ######
#      x      #
###############
